 ----------------
|                |
|      B    B    |
|                |
|                |
|                |
|                |
|      B    P    |
|                |
|      B  B  BBBB|
|    B       B   |
|         BBBB  E|
 ----------------