 ----------------
|BB  P BBBB    BB|
|BBB   BBBB   BBB|
| BBB  BBBB  BBB |
|  BBB BBBBBBBB  |
|    BBBBBBBB    |
|      BBBB      |
| BBBBBBBBBBBBBBB|
| B   B B BBB BBB|
| BBB  B   B   B |
| B   B B BBB  B |
| BBBBBBBBBBBEBBB|
 ----------------