 ----------------
|P               |
|      B    B    |
|                |
|                |
|                |
|                |
|      B         |
|          BBBBBB|
|          BB B B|
|    B     BB  BB|
|          BBB  E|
 ----------------